%%%%%%%%%%%%%%%%%%%%%%%%%%%%%%%%%%%%%
%                                   %
%                          %%  %%%  %
%                          %%  %%% P%
%                      %%  %%  %%%%%%
%                      %%  %%  %%%%%%
%                  %%  %%  %%%%%%%%%%
%                  %%  %%  %%%%%    %
%              %%  %%  %%%%%%       %
%              %%  %%  %%%%%%       %
%          %%  %%  %%%%%%           %
%          %%  %%  %%%%%%           %
%      %%  %%  %%%%%%               %
%      %%  %%  %%%%%%               %
%  %%  %%  %%%%%%                   %
%  %%  %%  %%%%%%                   %
%  %%  %%%%%%                       %
%  %%  %%%%%%                       %
%  %%%%%%                           %
%  %%%%%%                           %
%                                   %
%                                   %
%                                   %
%                                   %
%                                   %
%                                   %
%.                                  %
%%%%%%%%%%%%%%%%%%%%%%%%%%%%%%%%%%%%%